0,1,2,3,0,1,2,3,0,1,2,3,0,1,2,3,0,1,2,3
95,95,95,95,95,95,95,3,0,1,2,3,0,1,2,2,2,1,2,3
95,95,95,95,95,95,95,3,0,1,2,3,0,1,1,1,0,1,2,3
0,1,2,3,95,1,1,2,0,1,2,3,1,1,1,3,0,1,2,3
0,1,2,1,1,1,1,2,0,1,1,1,1,2,2,3,2,1,2,3
0,1,2,3,1,1,2,2,1,1,1,2,0,1,2,3,0,1,2,3
0,1,2,3,1,1,1,1,1,2,2,3,0,1,2,3,0,1,2,3
0,1,2,3,1,1,1,1,1,1,2,3,0,1,1,1,1,1,2,3
0,1,2,3,0,1,2,3,0,1,1,1,1,1,2,1,0,1,8,3
0,1,2,3,0,1,2,3,0,1,2,3,0,1,1,3,0,1,2,3
